"a" = (/turf/wall,/area)
"b" = (/turf,/area)
"c" = (/turf/brick,/area)
"d" = (/obj/savepoint,/turf/brick,/area)
"e" = (/turf/grille,/area)
"f" = (/obj/savepoint,/turf,/area)
"g" = (/turf/grass/rock{tag = "icon-rock_grass (NORTHWEST)"; icon_state = "rock_grass"; dir = 9},/area)
"h" = (/turf/grass/rock,/area)
"i" = (/turf/grass/rock{tag = "icon-rock_grass (NORTHEAST)"; icon_state = "rock_grass"; dir = 5},/area)
"j" = (/turf/grass/rock/corners,/area)
"k" = (/turf/grass,/area)
"l" = (/turf/grass/rock/corners{tag = "icon-rock_grass_corners (NORTH)"; icon_state = "rock_grass_corners"; dir = 1},/area)
"m" = (/turf/grass/rock{tag = "icon-rock_grass (WEST)"; icon_state = "rock_grass"; dir = 8},/area)
"n" = (/mob/trainer/npc,/turf/grass,/area)
"o" = (/obj/terrain/grass,/turf/grass,/area)
"p" = (/turf/grass/rock{tag = "icon-rock_grass (EAST)"; icon_state = "rock_grass"; dir = 4},/area)
"q" = (/turf/grass/rock{tag = "icon-rock_grass (SOUTHWEST)"; icon_state = "rock_grass"; dir = 10},/area)
"r" = (/turf/grass/rock/corners{tag = "icon-rock_grass_corners (EAST)"; icon_state = "rock_grass_corners"; dir = 4},/area)
"s" = (/turf/grass/rock/corners{tag = "icon-rock_grass_corners (WEST)"; icon_state = "rock_grass_corners"; dir = 8},/area)
"t" = (/turf/grass/rock{tag = "icon-rock_grass (SOUTHEAST)"; icon_state = "rock_grass"; dir = 6},/area)
"u" = (/turf/wall/stone,/area)
"v" = (/turf/wall/forest,/area)
"w" = (/turf/wall/city,/area)
"x" = (/obj/item/potion,/turf,/area)
"y" = (/mob/npc,/turf/grass,/area)
"z" = (/turf/grass/rock{tag = "icon-rock_grass (NORTH)"; icon_state = "rock_grass"; dir = 1},/area)
"A" = (/obj/item/potion,/turf/grass,/area)
"B" = (/mob/npc/fightmaster,/turf/brick,/area)

(1,1,1) = {"
aaaaaaaaaaaaaaaaaaaaaaaaaaaaaaaaaaaaaaaaaaaaaaaaaa
abbbbbbbbbbbbbbbbbbbbbbbbbbbbbbbbbbbbbbbbbbbbbbbba
abbbbbbbbbbbbbbbbbbbbbbbbbbbbbbbbbbbbbbbbbbbbbbbba
abbbbbbbbbbbbbbbbbbbbbbbbbbbbbbbbbbbbbbbbbbbbbbbba
abbbbbbbbbbbbbbbbbbbbbbbbbbbbbbbbbbbbbbbbbbbbbbbba
abbbbbbbbbbbbbbbbbbbbbbbbbbbbbbbbbbbbbbbbbbbbbbbba
abbbbbbbbbbbbbbbbbbbbbbbbbbbbbbbbbbbbbbbbbbbbbbbba
abbbbbbbbbbbbbbbbbbbbbbbbbbbbbbbbbbbbbbbbbbbbbbbba
abbbbbbbbbbbbbbbbbbbbbbbbbbbbbbbbbbbbbbbbbbbbbbbba
abbbbbbbbbbbbbbbbbbbbbbbbbbbbbbbbbbbbbbbbbbbbbbbba
abbbbbbbbbbbbbbbbbbbbbbbbbbbbbbbbbbbbbbbbbbbbbbbba
abbbbbbbbbbbbbbbbbbbbbbbbbbbbbbbbbbbbbbbbbbbbbbbba
abbbbbbbbbbbbbbbbbbbbbbbbbbbbbbbbbbbbbbbbbbbbbbbba
abbbbbbbbbbbbbbbbbbbbbbbbbbbbbbbbbbbbbbbbbbbbbbbba
abbbbbbbbbbbbbbbbbbbbbbbbbbbbbbbbbbbbbbbbbbbbbbbba
abbbbbbbbbbbbbbbbbbbbbbbbbbbbbbbbbbbbbbbbbbbbbbbba
abbbbbbbbbbbbbbbbbbbbbbbbbbbbbbbbbbbbbbbbbbbbbbbba
abbbbbbbbbbbbbbbbbbbbbbbbbbbbbbbbbbbbbbbbbbbbbbbba
abbbbbbbbbbbbbbbbbbbbbbbbbbbbbbbbbbbbbbbbbbbbbbbba
abbbbbbbbbbbbbbbbbbbbbbbbbbbbbbbbbbbbbbbbbbbbbbbba
abbbbbbbbbbbbbbbbbbbbbbbbbbbbbbbbbbbbbbbbbbbbbbbba
abbbbbbbbbbbbbbbbbbbbbbbbbbbbbbbbbbbbbbbbbbbbbbbba
abbbbbbbbbbbbbbbbbbbbbbbbbbbbbbbbbbbbbbbbbbbbbbbba
abbbbbbbbbbbbbbbbbbbbbbbbbbbbbbbbbbbbbbbbbbbbbbbba
abbbbbbbbbbbbbbbbbbbbbbbbbbbbbbbbbbbbbbbbbbbbbbbba
abbbbbbbbbbbbbbbbbbbbbbbbbbbbbbbbbbbbbbbbbbbbbbbba
abbbbbbbbbbbbbbbbbbbbbbbbbbbbbbbbbbbbbbbbbbbbbbbba
abbbbbbbbbbbbbbbbbbbbbbbbbbbbbbbbbbbbbbbbbbbbbbbba
abbbbbbbbbbbbbbbbbbbbbbbbbbbbbbbbbbbbbbbbbbbbbbbba
accccccccccccccccccccccccccccccdbbbbbbbbbbbbbbbbba
aeeeeeeeeeeeeeeeeeeeeeeeeeeeccccbbbbbbbbbbbbbbbbba
aeeeeeeeeeeeeeeeeeeeeeeeeeeeccccbbbbbbbbbbbbbbbbba
aebbbbbbbbbbbbbbbbaabaabaabbccccbbbbbbbbbbbbbbbbba
aebbfbbbbbghhhhhibaabaabaabbccccbbbbbbbbbbbbbbbbba
aeghhibbghjkkkkklhhhhhbbbbbbccccbbbbbbbbbbbbbbbbba
aemkklhhjknkkkkkkkkkkklbbbbbccccbbbbbbbbbbbbbbbbba
aemkkkkkkkkkkoooooooookpbbbbccccbbbbbbbbbbbbbbbbba
aemkkkkkkkkoooooooooookpbbbbccccbbbbbbbbbbbbbbbbba
aeqrkkkkkkooooooooookkstbbbbccccbbbbbbbbbbbbbbbbba
aegjkkkkooooooookuukvvpbwwbbccccbbbbbbbbbbbbbbbbba
aemkkkkoooooookkkuukvvpbwwbbccccbbbbbbbbbbbbbbbbba
aemkkkoooooookkkkkkkkkpbbbbxccccbbbbbbbbbbbbbbbbba
aemkooooooookkkykkkkkklibbbbccccbbbbbbbbbbbbbbbbba
aemkooooookkszzrkkkkkkkpbbbbccccbbbbbbbbbbbbbbbbba
aemkoooookkstbbqrkkkAkkpbbbbccccbbbbbbbbbbbbbbbbba
aemkkkkkkkstbeebqrkkkkkpbbfbccBcxbbbbbbbbbbbbbbbba
aeqzzzzzzztbbeebbqzzzzztbbbbccccbbbbbbbbbbbbbbbbba
aeeeeeeeeeeeeeeeccccccccccccccccbbbbbbbbbbbbbbbbba
aeeeeeeeeeeeeeeeccccccccccccccccbbbbbbbbbbbbbbbbba
aaaaaaaaaaaaaaaaaaaaaaaaaaaaaaaaaaaaaaaaaaaaaaaaaa
"}
